NO ./texture/rockwall.xpm
EA ./texture/rockwall.xpm
SO ./texture/rockwall.xpm
WE ./texture/rockwall.xpm
F 0,0,0
C 255,255,255

111111
1000X1
1000N1
111111
