NO ./texture/rockwall.xpm
EA ./texture/rockwall.xpm
SO ./texture/rockwall.xpm
WE ./texture/rockwall.xpm
F 120,120,120
C 100,100,100

111111
1S0001
1000N1
111111
