111111
1000N1
100001
111111
NO ./texture/rockwall.xpm
EA ./texture/rockwall.xpm
SO ./texture/rockwall.xpm
WE ./texture/rockwall.xpm
F 220,220,220
C 255,255,255
