NO ./texture/gray.xpm
EA ./texture/blue.xpm
SO ./texture/red.xpm
WE ./texture/green.xpm

F 34,139,34
C 55,0,255



1111111111111111
1000000000000001
1001111111110001
1010000000000001
1010011100111001
10S1001000010001
1111111111111111