NO ./path_to_the_north_texture
SO ./path_to_the_south_texture
WE ./path_to_the_west_texture
EA ./path_to_the_east_texture

F 220,10,0
C 55,0,255



111111111111111111111111111111111
100000000000000001000000000000001
100000000000000S00000000000000001
100000000000000000000000000000001
100000000000000000000000000000001
100001000000000000000000001000001
100000000000000000000000000000001
100000000000000000000000000000001
100000000000000000000000000000001
100001000000000000000000001000001
100000000000000000000000000000001
100000000000000000000000000000001
100000000000000000000000000000001
100001000000000000000000001000001
100000000000000000000000000000001
111111111111111111111111111111111
