NO ./texture/gray.xpm
EA ./texture/blue.xpm
SO ./texture/red.xpm
WE ./texture/green.xpm

F 34,139,34
C 55,0,255



11111111111111111
10000000000000001
10011111111100001
10010000000000001
10010011100111001
10S10010000100001
11111111111111111