NO ./texture/wall_north480.xpm
SO ./texture/wall_south480.xpm
WE ./texture/wall_west480.xpm
EA ./texture/wall_east480.xpm

F 220,10,0
C 55,0,255



1111111111111
1000000000001
1000000000001
100000S000001
1000000000001
1000000000001
1111111111111