NO ./texture/rockwall.xpm
EA ./texture/rockwall.xpm
SO ./texture/rockwall.xpm
WE ./texture/rockwall.xpm

F 72,72,72 
C 28,25,22

1111111111111111
1000000000000001
1011111111111101
1010000000000001
1010111111111001
1S10000000000001
1111111111111111